#########
#.......#
#..C#C..#
#..#T#..#
#..@T...#
#..###..#
#...C...#
#...T...#
#########