#######
#.....#
#..C..#
#.#C#T#
#..@..#
#T#C#.#
#.....#
#######