#######
#.....#
#..T..#
#..C..#
#..@..#
#.....#
#######
